############
#!        !#
#          #
#          #
#   EIMG   #
#   OACL   #
#   KDBP   #
#   HNJF   #
#          #
#          #
#!        !#
############