####################
#!                !#
#                  #
#                  #
#                  #
#                  #
#                  #
#                  #
#       EIMG       #
#       OACL       #
#       KDBP       #
#       HNJF       #
#                  #
#                  #
#                  #
#                  #
#                  #
#                  #
#!                !#
####################